NO ./assets/wall.xpm
SO ./assets/wall.xpm
WE ./assets/wall.xpm
EA ./assets/wall.xpm
F 225,100,0
C 223,20,0 

DR door01,/assets/debug.xpm,5,2,1,C,U
DR door02,/assets/debug.xpm,4,3,1,C,U
DR door03,/assets/debug.xpm,6,3,1,C,U
DR door04,/assets/debug.xpm,5,4,1,C,U

111111111
100000001
111101111
1000N0001
111101111
100000001
111111111