NO ./assets/wall.xpm
SO ./assets/wall.xpm
WE ./assets/wall.xpm
EA ./assets/wall.xpm
F 225,100,0
C 223,20,0 

DR door01,/assets/debug.xpm,24,10,1,C,L

KE key01,/assets/debug.xpm,door01,26,10,A,N
AL turd,NULL,O,5,10,120
AL get_turd,turd,H,25,2,120
FL task01,door01,O,28,11
MM F
EN patrick,NULL,1,35,16,P
                111111111111111
                100000000000001
                100010000000001          1111 
                100010000000001111111111100001
                100010000000001000000000000001
                100010000000000000001111100001
                100010000000000000001    1111 
                100010000011111111101
                100011110111000010001
                110000010001000000001
                110000010001000010001
                111110011101110110001
                100000000000000010001
                100000000000000010001
1111111         100000000000000010001
1000001         100000000000000010001
10000011111111111000000000N0000010001
1000000000000000000000000000000010001
1000001111111111111111111111111111111
1000001
1111111
