NO ./assets/wall.xpm
SO ./assets/wall.xpm
WE ./assets/wall.xpm
EA ./assets/wall.xpm
F 225,100,0
C 223,20,0 

DR door01,/assets/debug.xpm,21,5,1,C,U
KE key01,/assets/debug.xpm,door01,26,10,A,N
AL turd,NULL,O,5,10,120
AL get_turd,turd,H,25,2,120
MM F
EN patrick,NULL,1,28,6,P
WN 32,0
WN 31,0
WN 32,1
DR door02,/assets/debug.xpm,33,2,1,C,U
        1111111111111111111111111
        1000000000110000000000001
        101100000111000000000E001
        1001000000000000000000001
111111111011000001110000000000001
100000000011000001110111111111111
11110111111111011100000010001
11110111111111011101010010001
11000000110101011100000010001
10000000000000001100000010001
10000000000000001101010000001
1100000111010101111101111000111
11110111 1110101 101111010001
11111111 1111111 111111111111
