NO ./assets/wall.xpm
SO ./assets/wall.xpm
WE ./assets/wall.xpm
EA ./assets/wall.xpm
F 225,100,0
C 223,20,0 

DR door01,/assets/debug.xpm,25,10,1,C,U
KE key01,/assets/debug.xpm,door01,26,10,A,N
AL turd,NULL,O,5,10,120
AL get_turd,turd,H,25,2,120
MM F
WN 24,0
DR door2,/assets/debug.xpm,26,0,1,C,U

EN patrick,NULL,1,28,6,P
        1111111111111111111111111
        1000000000110000000000001
        1011000001110000N00000001
        1001000000000000000000001
111111111011000001110000000000001
100000000011000001110111111111111
11110111111111011100000010001
11110111111111011101010010001
11000000110101011100000010001
10000000000000001100000010001
10000000000000001101010000001
1100000111010101111101111000111
11110111 1110101 101111010001
11111111 1111111 111111111111
