NO ./assets/wall.xpm
SO ./assets/wall.xpm
WE ./assets/wall.xpm
EA ./assets/wall.xpm
F 225,1,0
C 223,20,0 

1111 1111
1😁N1 1001
1111 1111
