NO ./assets/wall.xpm
SO ./assets/wall.xpm
WE ./assets/wall.xpm
EA ./assets/wall.xpm

WN 7,2

WN 1,16

WN 4,16
WN 5,16
WN 6,16
WN 7,16


WN 9,16
WN 10,16
WN 11,16

WN 5,17
WN 11,17
WN 11,18
WN 5,19
WN 11,19

WN 5,20
WN 6,20
WN 8,20
WN 10,20
WN 11,20

WN 5,21
WN 6,21
WN 8,21
WN 10,21
WN 11,21

WN 5,22
WN 6,22
WN 8,22
WN 10,22
WN 11,22

DR door01,/assets/debug.xpm,12,11,1,C,U

OB orbit01,NULL,O,7,9,E
OB orbit02,NULL,O,7,8,S
OB orbit02,NULL,O,10,9,W
OB orbit02,NULL,O,6,10,N


111111111111111111111111
100000000000101100000001
101111111100101100010101
100000000000101100001001
100000000000101100010101
100000000000101100000001
100000000000100000000001
100001110111101100000001
100001000001101100000001
100001100001101110111111
100001000001101110111111
10000110N000000000010001
100001000001101111101111
100001100001101111101111
100001000001101100000001
100001110111101100000001
110011110111101101010101
100001000001101100000001
100000000001101100000001
100001000001101111101111
100001101011101100101001
100001101011101100000001
100001101011101100101001
111111111111111111111111