NO ./assets/wall.xpm
SO ./assets/wall.xpm
WE ./assets/wall.xpm
EA ./assets/wall.xpm
F 225,100,0
C 223,20,0

DR door01,/assets/debug.xpm,25,11,1,C,L
DR door02,/assets/debug.xpm,20,1,1,C,L
DR door03,/assets/debug.xpm,40,4,1,C,L
DR door04,/assets/debug.xpm,16,17,1,C,L

DR door05,/assets/debug.xpm,30,11,1,C,U
DR door06,/assets/debug.xpm,32,9,1,C,U
DR door07,/assets/debug.xpm,25,8,1,C,U

DR door08,/assets/debug.xpm,35,7,1,O,U

KE key01,/assets/debug.xpm,door01,26,10,A,N

AL at_door03,NULL,O,39,4,120
AL al_task03,at_door03,M,0,0,120
AL at_task05,NULL,O,23,7,120
AL al_task04,at_task05,M,0,0,120

AL al_win,NULL,O,3,17,120
AL at_door04,al_win,H,15,17,120
AL al_task05,at_door04,M,0,0,120

FL task01,door01,O,27,11
FL task02,door02,O,19,0
FL task03,t_d03,O,30,3
FL task05,t_t05,C,23,8
FL task04,t_t04,O,42,4

GM t_d03,door03,al_task03,NULL
GM t_t04,al_task04,task05,NULL
GM t_t05,al_task05,door04,NULL

TA ta01,orbit01,O,12,17,101,P,E
OB orbit01,gm_fin,C,1,17,E
GM gm_fin,dr_fin,al_win,NULL
DR dr_fin,/assets/debug.xpm,1,14,1,C,L

WL 32,12,32,18
WL 6,18,31,18
WL 0,14,6,20
WL 31,2,44,3
WL 37,5,44,6
WN 44,4
MM F
EN patrick,NULL,2,35,16,P
                111111111111111
                100000000000001
                100010000000001         11111
                10001000000000111111111110001
                10001000000000100000000000001
                10001000000000000000111110001
                100010000000000000001   11111
                100010000011111111101
                100011111011000010001
                110000010001000000001
                110000010001000010001
                111110011011110110001
                100000000000000010001
                100000000000000010001
1111111         100000000000000010001
1000001         100000000000000010001
100000111111111110000000000S000010001
1000000000000000000000000000000010001
1000001111111111111111111111111111111
1000001
1111111