NO ./assets/wall.xpm
SO ./assets/wall.xpm
WE ./assets/wall.xpm
EA ./assets/wall.xpm
F 225,100,0
C 223,20,0

DR dr_fin,/assets/debug.xpm,23,0,1,C,L
TA ta01,you_win,O,23,1,101,P,E

VC you_win,NULL

WN 8,21
WL 0,15,41,15
WL 22,0,22,5
WL 24,0,24,5
WN 0,23
WL 0,5,41,5
WL 29,25,29,32
WL 31,25,31,32
WN 30,32
WL 12,25,12,32
WL 10,25,10,32
WN 11,32
MM F
EN patrick,NULL,2,31,31,P
                      111
                      101
                      101
                      101
                      101
11111111111111111111111E111111111111111111
101000100000100010001010101000000100010001
100010001110001010101010100011110101000101
101000100010100011101010100101000101111101
111111111011111000000010100100010101000101
100010001000001101011110100101111101010101
101010101111101000001010100101000101010101
101010101000101111101010100101010101010101
101000100010000000101010000100010001010001
101111111111111100100010011111111111010111
100000000000100000100010010000000000010001
111101110110101111100010010111111111111101
100000100010100010101110010100010000000001
111110111010111010101000110101010110011111
100010100010000010101011110101010100010001
101010101111111010001000010101010101110101
101000001000100010111111010101000100000101
101111111110101000000100010101111111111101
100000000000101010010001010001000000000001
111111111110111111111111111111011111111111
          101                101
          101                101
          101                101
          101                101
          101                101
          101                101
          101                101
          111                111