NO ./assets/wall.xpm
SO ./assets/wall.xpm
WE ./assets/wall.xpm
EA ./assets/wall.xpm

DR dr_fin,/assets/debug.xpm,16,6,1,C,L
TA ta01,you_win,O,16,9,101,P,E

PI welcome,NULL,44,100,180
TA ta02,welcome,O,16,21,101,P,E

VC you_win,NULL
WN 16,10
WN 18,9
WN 14,9
WL 0,6,31,6
WL 0,20,31,20
WL 5,7,5,19
WL 27,7,27,19
MM O
EN patrick,NULL,2,16,5,P

OB orbit01,a_in01,O,1,1,S
OB orbit02,a_in01,O,30,1,S
OB orbit03,a_in02,O,1,25,N
OB orbit04,a_in02,O,30,25,N

GA a_in00,dr_fin,a_in01,a_in02
GA a_in01,a_in00,orbit01,orbit02
GA a_in02,a_in00,orbit03,orbit04
AL at_task01,NULL,O,16,8,120
AL al_task02,at_task01,M,17,21,120
111                          111
101                          101
101                          101
101                          101
10111111111111111111111111111101
10000000000000000000000000000001
11110111111111110111111111110111
   101         101         101
   101        11011        101
   101        10001        101
   101        11111        101
   101                     101
   101                     101
   101                     101
   101                     101
   101                     101
   101                     101
   101                     101
   101                     101
   101                     101
11110111111111111111111111110111
1000000000000000N000000000000001
10111111111111111111111111111101
101                          101
101                          101
101                          101
111                          111