NO ./assets/wall.xpm
SO ./assets/wall.xpm
WE ./assets/wall.xpm
EA ./assets/wall.xpm

WL 0,0,27,19

OB ob_tsot,ga_exit,O,24,3,W

EN en_enem,NULL,2,1,10,P

TA ta_enem,dc_enem,O,17,3,100,P,E

DR dr_ts1,T,9,4,1,C,U

DC dc_enem,dr_enem,O
DR dr_enem,O,1,9,1,C,U

GA ga_exit,dc_exit,dr_tshw2,ta_fin
DC dc_exit,dr_exit_ob,O

DR dr_exit_ob,T,18,6,1,C,U
DR dr_tshw1,T,9,10,1,C,U
DR dr_tshw2,T,17,10,1,C,L

DR dr_msal,T,13,15,1,C,U

DR dr_tsal,T,13,11,1,C,U
FL fl_dr_tsal,dr_tsal,O,12,12
TA ta_fin,vc_win,C,13,16,100,P,E

VC vc_win,NULL

         1111111111111111
         10001000100000001
 1111111110101010100000001
1000000001010101E000000001
10000000000101011100000001
10000000011100010100000001
10000000011111111101111111
1000000001       10100011
1000000001       10001011
1011000001111111111111011
1001000000000000000000011
 111111111111011111111111
            101
            101
            101
    11111111101111111111111
   1000000000000000000000001
  1000000000000000000000111
   1000000000000000000000001
    11111111111111111111111