

NO ./assets/wall.xpm
SO ./assets/wall.xpm
WE ./assets/wall.xpm
EA ./assets/wall.xpm

WN 14,16
WN 3,4
WN 20,2
WN 33,14
WN 9,12
WN 33,4
WN 3,10
MM F
PI welcome,NULL,47,100,180
TA ta02,welcome,O,1,19,101,P,E

VC you_win,NULL

GA a_in09,you_win,a_in00,a_in03
GA a_in00,a_in09,a_in01,a_in02
GA a_in01,a_in00,task01,task02
GA a_in02,a_in00,task03,task04
GA a_in03,a_in09,task05,a_in04
GA a_in04,a_in03,orbit02,orbit01


FL task01,a_in01,O,13,0
FL task02,a_in01,O,18,6
FL task03,a_in02,O,32,7
FL task04,a_in02,O,0,3
FL task05,a_in03,O,27,3
OB orbit01,a_in04,O,24,19,N
OB orbit02,a_in04,O,40,1,N
EN patrick,NULL,2,20,4,P

111111111111111111111111111111111111111111
101000001000000000001001010111011111111101
101010101011111110001000010000000000010001
100010100010000010001001011111111111010101
111110101111101011100001000100000100010101
100000101000101000000011110101110101110111
101111101011101111110010000101000100010001
101000001010100000100011111101011111011101
101011111010111110110000000101010001010001
101010001010100010100011111101011111011101
101110101010101000100000000101010001010001
100000101010001010001001110101010101010101
111110111111111111100001010001010100010101
100000101000100010000101011111010111110101
101110101110101110110001000001010100000101
101000100000100010110011111101011101111111
101011111111111010100000000101000101000001
100010000000000010000011110101111101011101
101010111011111111100000010100010000010001
1N1000001000000000000001010101011111110001
111111111111111111111111111111111111111111