NO ./assets/wall.xpm
SO ./assets/wall.xpm
WE ./assets/wall.xpm
EA ./assets/wall.xpm
F 225,100,0
C 223,20,0 

OB orbit01,NULL,O,2,1,S
OB orbit04,NULL,O,3,2,W
OB orbit03,NULL,O,2,3,N
OB orbit02,NULL,O,1,2,E

11111
11011
10N01
11011
11111