NO ./assets/wall.xpm
SO ./assets/wall.xpm
WE ./assets/wall.xpm
EA ./assets/wall.xpm
F 225,100,0
C 223,20,0 

WN 0,0
WN 1,0
WN 2,0
WN 3,0
WN 4,0
WN 5,0
WN 6,0
WN 7,0
WN 8,0
WN 9,0
WN 10,0
WN 11,0
WN 12,0
WN 13,0
WN 14,0
WN 15,0
WN 16,0
WN 17,0
WN 18,0
WN 19,0
WN 20,0
WN 21,0
WN 22,0
WN 23,0
WN 24,0

WN 0,0
WN 1,0
WN 2,0
WN 3,0
WN 4,0
WN 5,0
WN 6,0
WN 7,0
WN 8,0
WN 9,0
WN 10,8
WN 11,8
WN 12,8
WN 13,8
WN 14,8
WN 15,8
WN 16,8
WN 17,8
WN 18,8
WN 19,8
WN 20,8
WN 21,8
WN 22,8
WN 23,8
WN 24,8
WN 23,8

WN 0,0
WN 0,1
WN 0,2
WN 0,3
WN 0,4
WN 0,5
WN 0,6
WN 0,7
WN 0,8
WN 0,9

WN 33,0
WN 33,1
WN 33,2
WN 33,3
WN 33,4
WN 33,5
WN 33,6
WN 33,7
WN 33,8
WN 33,9

         1111111111111111111111111
         1000000000000000000000001
1111111111000000000000000000000001
1000000000000000000000000000000001
100000000000000000000N000000000001
1000000000111111111000000000000001
10000000001       1000000000000001
10000000001       1000000000000001
1000000000111111111000000000000001
1000000000000000000000000000000001
1111111111111111111111111111111111