NO ./assets/wall.xpm
SO ./assets/wall.xpm
WE ./assets/wall.xpm
EA ./assets/wall.xpm
F 225,100,0
C 223,20,0 

DR door01,/assets/debug.xpm,2,3,1,C,L

FL task01,and01,O,0,4
FL task02,and01,O,4,4
GA and01,door01,task01,task02

11111
10001
10001
11011
10N01
10001
11111