NO ./assets/wall.xpm
SO ./assets/wall.xpm
WE ./assets/wall.xpm
EA ./assets/wall.xpm
F 225,100,0,6
C 223,20,0 

11111
10001
10S01
10001
10001
11111
