NO ./hey_i_dont_think_this_is_a_real_path_wat_U_do_man/assets/wall.xpm
SO ./assets/wall.xpm
WE ./assets/wall.xpm
EA ./assets/wall.xpm
F 225,100,0
C 223,20,0 

1111111
1000001
1000N01
1000001
1111111
